%%%%%%%%%%%%
%P.   .G   %
% . G  .   %
%.%     .  %
%. ..  .%  %
%. G       %
%    .     %
% %      . %
% . . ..   %
%.       % %
%. .       %
%%%%%%%%%%%%
