%%%%%%%%%%%%%%
%PG..       .%
%            %
% .  .  .... %
%         .  %
%    G  G  ..%
%.    . ..   %
%       .    %
%     %     .%
%  %%.       %
%.         . %
% %          %
%      .  .  %
%%%%%%%%%%%%%%
