%%%%%%%%%%%%
%PG   ..   %
% ...%.G   %
%   .    % %
% %. .  .  %
%       % .%
% .   G   .%
%  % .     %
%   .% .   %
%  .%   .  %
% .        %
%%%%%%%%%%%%
