%%%%%%%%%%%%%%
%P    . .   .%
%  .  G     .%
%  . %  .   .%
%   . .G     %
%.   ..      %
%    .   GG .%
%      % . % %
%  .. .  .   %
%... %..     %
% .          %
%.  .%   .   %
%         .  %
%%%%%%%%%%%%%%
