%%%%%%%%%%%%%%%%%%
%P       G  .   .%
%    G  .%       %
%. .        .  %.%
% %%%    . . %   %
%    . %    ..  .%
%.       %     . %
%  %  . %    . . %
% %  % . .    .  %
% %              %
% . .%%%         %
%         .    . %
%       .   .. ..%
%    ...     ..  %
% .  ..          %
% .  .    .      %
%  .     . . .  .%
%%%%%%%%%%%%%%%%%%
