%%%%%%%%%%%%%%%%%
%P.        ..   %
% ..   .   G    %
%  .  % .%    G %
%   G % .   .  .%
%.     .   .   .%
%            % .%
%.    %  %.   % %
%     .   %  %  %
% %         . ..%
%     . %       %
%. .  .  .      %
%             % %
% .          . .%
%  %%     %  %  %
%.          .   %
%%%%%%%%%%%%%%%%%
