%%%%%%%%%%%%%%%%%
%P .  .G  G   . %
%. % .          %
% %    %% .     %
%.  ...  . %    %
%  ...         .%
%   .. .        %
%       .  .  ..%
% %. .%   %% . .%
% %     %.%.    %
%        .      %
%  .%  .      . %
%.   .      .   %
% %  %      . . %
%    ...%       %
%               %
%%%%%%%%%%%%%%%%%
