%%%%%%%%%%%%%
%P    .  G  %
%      % %  %
% .   % .%  %
% . . .     %
%.    .     %
%  . .  ..  %
%     .   % %
%     .%  . %
%   .  %  . %
%        %. %
% ..  .   . %
%%%%%%%%%%%%%
