%%%%%%%%%%%%%%
%P           %
%  %    G.  .%
%  %G  .     %
%   .       .%
%        .G  %
%. ..  %     %
% ..   %     %
%     % . %. %
%    .       %
% ..  .. .   %
%  %%    .%  %
%.   ..  ..  %
%%%%%%%%%%%%%%
